28
36
1111111111111111111111111111
1111111111111111111111111111
1111111111111111111111111111
1111111111111111111111111111
1------------11------------1
1-1111-11111-11-11111-1111-1
1-1111-11111-11-11111-1111-1
1-1111-11111-11-11111-1111-1
1--------------------------1
1-1111-11-11111111-11-1111-1
1-1111-11-11111111-11-1111-1
1------11----11----11------1
111111-11111011011111-111111
111111-11111011011111-111111
111111-11000000000011-111111
111111-11011111111011-111111
111111-11011111111011-111111
000000-00011111111000-000000
111111-11011111111011-111111
111111-11011111111011-111111
111111-11000000000011-111111
111111-11011111111011-111111
111111-11011111111011-111111
1------------11------------1
1-1111-11111-11-11111-1111-1
1-1111-11111-11-11111-1111-1
1---11-------<--------11---1
111-11-11-11111111-11-11-111
111-11-11-11111111-11-11-111
1------11----11----11------1
1-1111111111-11-1111111111-1
1-1111111111-11-1111111111-1
1--------------------------1
1111111111111111111111111111
1111111111111111111111111111
1111111111111111111111111111