10
10
1111111111
1000000001
1001111001
1000110001
1000000001
1000000001
1000000001
10<0000001
1000000001
1111111111